NO ./textures/Wall-1.png
SO ./textures/Wall-2.png
WE ./textures/Wall-3.png
EA ./textures/Wall-4.png

F 73,54,40
C 125,181,255

11111111111111111111
10100001000000000001
10101001110001111111
10111000000001000101
10000000000111000101
10000000000000000001
10000000000000000101
100000000S0000011111
10000000000000010001
100000000000000100111111111111111111111111111111111111111111111
100000000000000000000000000000000000000000000000000000000000001
100000000000000000000000000000000000000000000000000000000000001
100000000000000000000000000000000000000000000000000000000000001
100000000000000000010000000000000000000000000000000000000000001
111111111111111111111111111111111111111111111111111111111111111
