NO ./textures/Wall-1.png
SO ./textures/Wall-2.png
WE ./textures/Wall-3.png
EA ./skibi.png

F 73,54,40
C 125,181,255

11111111111111111111
10100001000000000001
10101001110001111111
10111000000001000101
100000000001110001011111111
100000000000000000000000001
100000000000000000011111101
100000000S0000011111    101
10000000000000010001    101
100000000000000100011111101111
100000000000000000000000000001
100000000000000000000000000001
100000000000000000000000000001
100000000000000000010000000001
111111111111111111111111111111