NO ./textures/Wall-1.png
SO ./textures/Wall-2.png
WE ./textures/Wall-3.png
EA ./textures/Wall-4.png

F 73,54,40
C 125,181,255

11111111111111111111
00100001000000000000
00101001110001111110
00111000000001000100
00000000000111000100
00000000000000000000
00000000000000000100
000000000S0000011110
00000000000000010000
000000000000000100111111111111
000000000000000000000000000000
000000000000000000000000000000
000000000000000000000000000000
000000000000000000010000000000
111111111111111111111111111111
