NO ./textures/Wall-1.png
SO ./textures/Wall-2.png
WE ./textures/Wall-3.png
EA ./textures/Wall-4.png

F 220,100,000
C 225,30,088

1111111
10000001
100S0001
10000001
11111111
