NO
SO
WE
EA

F
C

     1111111111111111111111111111111
    1100000000000001S0000000000000011
   11000000000000000000000000000000011
    110000111111111111111111110000011
     111111                  1111111
