 1111111
1000S1111
100011001
 111  1111
