NO ./textures/Wall-1.png
SO ./textures/Wall-2.png
WE ./textures/Wall-3.png
EA ./textures/Wall-4.png

F 220,100,0
C 225,30,0



     1111111111111111111111111111111
    1100000000000001S0000000000000011
   11000000000000000000000000000000011
    110000111111111111111111110000011
     111111                  1111111







